11111111
1000C001
10000111
10000EP1
11111111
