1111111111111111111111111111111111
11111111111111111111111111111110P1
1000C00000C0000000000C000000C110E1
10111111111111111111111111111110C1
1000C0000C00C0000000C000000000C001
1111111111111111111111111111111111
